###############
#      #      #
# #         # #
#  # #  #  #  #
#   #     #   #
#             #
##### # # #####
#             #
#   #     #   #
#  # #  #  #  #
# #         # #
#      #      #
###############