###############
#     ###     #
# ###  #  ### #
#  #   #   #  #
# ### # # ### #
#   #  #  #   #
## ## # # ## ##
#   #  #  #   #
# ### # # ### #
#  #   #   #  #
# ###  #  ### #
#     ###     #
###############