###############
#    # # #    #
# ## # # # ## #
#      #      #
#  # # # # #  #
#             #
##### # # #####
#             #
#  # # # # #  #
#      #      #
# ## # # # ## #
#    # # #    #
###############